16 16 16 16 16 16 16 16 16 16 16 16 16 16 16 16 16 16 16 16 16 16 16 16 16 16 16 16 16 16 16 16 16 16 16 16 16 16 16 16 
16 16 16 16 16 16 16 16 16 16 16 16 16 16 16 16 16 16 16 16 16 16 16 16 16 16 16 16 16 16 16 16 16 16 16 16 16 16 16 16 
16 16 16 16 16 16 16 16 16 16 16 16 16 16 16 16 16 16 16 16 16 16 16 16 16 16 16 16 16 16 16 16 16 16 16 16 16 16 16 16 
16 16 16 05 05 05 05 05 05 05 05 05 05 05 05 05 05 05 05 05 05 05 05 16 16 16 16 16 16 16 16 16 16 16 16 16 16 16 16 16 
16 16 03 17 17 17 17 17 17 17 17 17 17 18 18 18 18 18 18 18 18 18 18 02 16 16 16 16 16 16 16 16 16 16 16 16 16 16 16 16 
16 16 03 17 17 17 17 17 17 17 17 17 17 17 17 17 17 06 04 04 04 08 18 02 16 16 16 16 16 16 16 16 16 16 16 16 16 16 16 16 
16 16 03 17 17 17 17 17 17 17 17 17 17 17 17 17 17 02 16 16 16 03 18 02 16 16 16 16 16 16 16 16 16 16 16 16 16 16 16 16 
16 16 03 17 17 17 17 17 17 17 17 17 17 17 17 17 17 02 16 16 16 03 18 02 16 16 16 16 16 16 16 16 16 16 16 16 16 16 16 16 
16 16 03 17 17 17 17 17 17 17 17 17 17 17 17 17 17 07 05 05 05 03 18 02 16 16 16 16 16 16 16 16 16 16 16 16 16 16 16 16 
16 16 03 17 17 17 17 17 17 17 17 17 17 17 17 17 17 18 18 18 18 10 18 02 16 16 05 05 05 05 05 05 05 05 05 05 05 16 16 16 
16 16 03 17 17 17 17 17 17 17 17 17 17 17 17 17 17 06 04 08 18 10 18 02 16 03 17 17 17 17 17 17 17 17 17 17 17 02 16 16 
16 16 03 17 17 17 17 17 17 17 17 17 17 17 17 17 17 02 16 03 18 10 18 02 16 03 17 17 17 17 17 17 17 17 17 17 17 02 16 16 
16 16 16 04 04 04 04 04 04 04 04 04 04 04 04 04 04 16 16 03 18 10 18 07 05 09 17 17 17 17 17 17 17 17 17 17 17 02 16 16 
16 16 16 16 16 16 16 16 16 16 16 16 16 16 16 16 16 16 16 03 18 10 18 17 17 17 17 17 17 17 17 17 17 17 17 17 17 02 16 16 
16 16 16 16 16 16 16 16 16 16 16 16 16 16 16 16 16 16 16 03 18 10 18 17 18 18 17 17 17 17 17 17 17 17 17 17 17 02 16 16 
16 16 16 16 16 16 16 16 16 16 16 16 16 16 16 16 16 16 16 03 18 10 18 17 18 17 17 17 17 17 17 17 17 17 17 17 17 02 16 16 
16 16 16 16 16 16 16 16 16 16 16 16 16 16 16 16 16 16 16 03 18 10 18 17 18 17 17 17 17 17 17 17 17 17 17 17 17 02 16 16 
16 16 16 16 16 16 16 16 16 16 16 16 16 16 16 16 16 16 16 03 18 10 18 17 18 17 17 17 17 17 17 17 17 06 04 04 04 16 16 16 
16 16 16 16 16 16 16 16 16 16 16 16 16 16 16 16 16 16 16 03 18 10 18 17 18 17 17 17 17 17 17 17 17 07 05 05 05 16 16 16 
16 16 16 16 16 16 16 16 16 16 16 16 16 16 16 16 16 16 16 03 18 10 18 17 18 17 17 17 17 17 17 17 17 17 17 17 17 02 16 16 
16 16 16 16 16 16 16 16 16 16 16 16 16 16 16 16 16 16 16 03 18 10 18 17 18 17 17 17 17 17 17 17 17 17 17 17 17 02 16 16 
16 16 16 16 16 16 16 16 16 16 16 16 16 16 16 16 16 16 16 03 18 10 18 17 18 17 17 17 17 17 17 17 17 17 17 17 17 02 16 16 
16 16 16 16 16 16 16 16 16 16 16 16 16 16 16 16 16 16 16 03 18 10 18 17 18 17 17 17 17 17 17 17 17 17 17 17 17 02 16 16 
16 16 16 16 16 16 16 16 16 16 16 16 16 16 16 16 16 16 16 03 18 10 18 17 18 17 17 17 17 17 17 17 17 17 17 17 17 02 16 16 
16 16 16 16 16 16 16 16 16 16 16 16 16 16 05 05 05 05 05 09 18 10 18 17 18 17 17 17 17 17 17 17 17 17 17 17 17 02 16 16 
16 16 16 16 16 16 16 16 16 16 16 16 16 09 17 17 17 17 17 17 18 14 18 17 18 17 17 17 17 17 17 17 17 17 17 17 17 02 16 16 
16 16 16 16 16 16 16 16 16 16 16 16 03 17 17 17 17 17 17 17 18 18 18 18 18 18 18 17 17 17 17 17 17 17 17 17 17 02 16 16 
16 16 16 16 16 16 16 16 16 16 16 16 03 17 17 17 17 17 17 17 17 15 18 18 18 06 04 08 17 17 17 17 17 17 17 17 17 02 16 16 
16 16 16 16 16 16 16 16 16 16 16 16 03 17 17 17 17 17 17 17 17 10 18 18 18 02 16 03 17 17 17 17 17 17 17 17 17 02 16 16 
16 16 16 16 16 16 16 16 16 16 16 16 03 17 17 17 17 17 17 17 17 10 18 18 18 02 16 03 17 17 17 17 17 17 17 17 17 02 16 16 
16 16 16 16 16 16 16 16 16 16 16 16 03 17 17 17 17 17 17 17 17 14 18 18 18 07 05 09 17 17 17 17 17 17 17 17 17 02 16 16 
16 16 16 16 16 16 16 16 16 16 16 16 03 17 17 17 17 17 17 18 18 18 18 18 18 18 18 18 18 18 18 18 18 18 18 18 17 02 16 16 
16 16 16 16 16 16 16 16 16 16 16 16 03 18 18 18 18 18 18 18 18 18 18 18 18 06 04 08 17 17 17 17 17 17 17 17 17 02 16 16 
16 16 16 16 16 16 16 16 16 16 16 16 03 19 17 17 17 17 17 17 17 15 18 18 06 16 16 03 17 17 17 17 17 17 17 17 17 02 16 16 
16 16 16 16 16 16 16 16 16 16 16 16 03 17 17 17 17 17 17 17 17 14 18 18 02 16 16 03 17 17 17 17 17 17 17 17 17 02 16 16 
16 16 16 16 16 16 16 16 16 16 16 16 03 17 17 17 17 17 17 18 18 18 18 18 02 16 16 03 17 17 17 17 17 17 17 17 17 02 16 16 
16 16 16 16 16 16 16 16 16 16 16 16 03 17 17 17 17 17 17 17 17 18 18 06 16 16 16 03 17 17 17 17 17 17 17 17 17 02 16 16 
16 16 16 16 16 16 16 16 16 16 16 16 16 04 04 04 04 04 04 04 04 04 04 16 16 16 16 16 04 04 04 04 04 04 04 04 04 16 16 16 
16 16 16 16 16 16 16 16 16 16 16 16 16 16 16 16 16 16 16 16 16 16 16 16 16 16 16 16 16 16 16 16 16 16 16 16 16 16 16 16 
16 16 16 16 16 16 16 16 16 16 16 16 16 16 16 16 16 16 16 16 16 16 16 16 16 16 16 16 16 16 16 16 16 16 16 16 16 16 16 16 

