16 16 16 16 16 16 16 16 16 16 16 16 16 16 16 16 16 16 16 16 16 16 16 16 16 16 16 16 16 16 16 16 16 16 16 16 16 16 16 16 
16 16 16 16 16 16 16 16 16 16 16 16 16 16 16 16 16 16 16 16 16 16 16 16 16 16 16 16 16 16 16 16 16 16 16 16 16 16 16 16 
16 16 16 16 16 16 16 16 16 16 16 16 16 16 16 16 16 16 16 16 16 16 16 16 16 16 16 16 16 16 16 16 16 16 16 16 16 16 16 16 
16 16 16 16 16 16 16 05 05 05 05 05 05 05 05 05 05 16 16 16 16 16 16 16 16 16 16 16 16 16 16 16 16 16 16 16 16 16 16 16 
16 16 16 16 16 16 03 17 17 17 17 17 17 17 17 17 17 02 16 16 16 16 16 16 16 16 16 16 16 16 16 16 16 16 16 16 16 16 16 16 
16 16 16 16 16 16 03 17 17 17 19 17 17 17 17 17 17 02 16 16 16 16 16 16 16 16 16 16 16 16 16 16 16 16 16 16 16 16 16 16 
16 16 16 16 16 16 03 17 17 17 17 17 17 17 17 17 17 02 16 16 16 16 16 16 16 16 16 16 16 16 16 16 16 16 16 16 16 16 16 16 
16 16 16 16 16 16 03 17 17 17 17 17 17 17 17 17 17 02 16 16 16 16 16 16 16 16 16 16 16 16 16 16 16 16 16 16 16 16 16 16 
16 16 16 16 16 16 03 17 17 17 17 17 17 17 17 17 17 02 16 16 16 16 16 16 16 16 16 16 16 16 16 16 16 16 16 16 16 16 16 16 
16 16 16 16 16 16 03 17 17 17 17 17 17 17 17 17 17 02 16 16 16 16 16 16 16 16 16 16 16 16 16 16 16 16 16 16 16 16 16 16 
16 16 16 16 16 16 03 17 17 17 17 17 17 17 17 17 17 02 16 16 16 16 16 16 16 16 16 16 16 16 16 16 16 16 16 16 16 16 16 16 
16 16 16 16 16 16 03 17 17 17 17 17 17 17 17 17 17 02 16 16 16 16 16 16 16 16 16 16 16 16 16 16 16 16 16 16 16 16 16 16 
16 16 16 16 16 16 03 17 17 17 17 17 17 17 17 17 17 02 16 16 16 16 16 16 16 16 16 16 16 16 16 16 16 16 16 16 16 16 16 16 
16 16 16 16 16 16 03 17 17 17 17 17 17 17 17 17 17 02 16 16 16 16 16 16 16 16 16 16 16 16 16 16 16 16 16 16 16 16 16 16 
16 16 16 16 16 16 03 17 17 17 17 17 17 17 17 17 17 02 16 16 16 16 16 16 16 16 16 16 16 16 16 16 16 16 16 16 16 16 16 16 
16 16 16 16 16 16 03 17 17 17 17 17 17 17 17 17 17 02 16 16 16 16 16 16 16 16 16 16 16 16 16 16 16 16 16 16 16 16 16 16 
16 16 16 16 16 16 16 04 04 04 04 04 04 08 18 06 04 16 16 16 16 16 16 16 16 16 16 16 16 16 16 16 16 16 16 16 16 16 16 16 
16 16 16 16 16 16 16 16 16 16 16 16 16 03 18 02 16 16 16 16 16 16 16 16 16 16 16 16 16 16 16 16 16 16 16 16 16 16 16 16 
16 16 16 16 16 16 16 16 16 16 16 16 16 03 18 02 16 16 16 16 16 16 16 16 16 16 16 16 16 16 16 16 16 16 16 16 16 16 16 16 
16 16 16 16 16 16 16 16 16 16 16 16 16 03 18 02 16 16 16 16 16 16 16 16 16 16 16 16 16 16 16 16 16 16 16 16 16 16 16 16 
16 16 16 16 16 16 16 16 16 16 16 16 16 03 18 02 16 16 16 16 16 16 16 16 16 16 16 16 16 16 16 16 16 16 16 16 16 16 16 16 
16 16 16 16 16 16 16 16 16 16 16 16 16 03 18 02 16 16 16 16 16 16 16 16 16 16 16 16 16 16 16 16 16 16 16 16 16 16 16 16 
16 16 16 16 16 16 16 16 16 16 16 16 16 03 18 02 16 16 16 16 16 16 16 16 16 16 16 16 16 16 16 16 16 16 16 16 16 16 16 16 
16 16 16 16 16 16 16 16 16 16 16 16 16 03 18 02 16 16 16 16 16 16 16 16 16 16 16 16 16 16 16 16 16 16 16 16 16 16 16 16 
16 16 16 16 16 16 16 05 05 05 05 05 05 09 18 07 16 16 16 16 16 16 16 16 16 16 16 16 16 16 16 16 16 16 16 16 16 16 16 16 
16 16 16 16 16 16 03 17 17 17 17 17 17 17 17 18 07 05 05 05 05 05 05 05 05 05 16 16 16 16 16 16 16 16 16 16 16 16 16 16 
16 16 16 16 16 16 03 17 17 17 17 17 17 17 17 18 17 17 17 17 17 17 17 17 17 17 02 16 16 16 16 16 16 16 16 16 16 16 16 16 
16 16 16 16 16 16 03 17 17 17 17 17 17 17 17 18 17 17 17 17 17 17 17 17 17 17 02 16 16 16 16 16 16 16 16 16 16 16 16 16 
16 16 16 16 16 16 03 17 17 17 17 17 17 17 17 17 17 17 17 17 17 17 17 17 17 17 02 16 16 16 16 16 16 16 16 16 16 16 16 16 
16 16 16 16 16 16 03 17 17 17 17 17 17 17 17 17 17 17 17 17 17 17 17 17 17 17 02 16 16 16 16 16 16 16 16 16 16 16 16 16 
16 16 16 16 16 16 03 17 17 17 17 17 17 17 17 17 17 17 17 17 17 17 17 17 17 17 02 16 16 16 16 16 16 16 16 16 16 16 16 16 
16 16 16 16 16 16 03 17 17 17 17 17 17 17 17 17 17 17 18 18 18 18 18 18 18 17 02 16 16 16 16 16 16 16 16 16 16 16 16 16 
16 16 16 16 16 16 03 17 17 17 17 17 17 17 17 17 17 17 18 18 17 17 17 17 17 17 02 16 16 16 16 16 16 16 16 16 16 16 16 16 
16 16 16 16 16 16 03 17 17 17 17 17 17 17 17 17 17 17 17 17 17 17 17 17 17 17 02 16 16 16 16 16 16 16 16 16 16 16 16 16 
16 16 16 16 16 16 03 17 17 17 17 17 17 17 17 17 17 17 17 17 17 17 17 17 17 17 02 16 16 16 16 16 16 16 16 16 16 16 16 16 
16 16 16 16 16 16 03 17 17 17 17 17 17 17 17 17 17 17 17 17 17 17 17 17 17 17 02 16 16 16 16 16 16 16 16 16 16 16 16 16 
16 16 16 16 16 16 03 17 17 17 17 17 17 17 17 17 17 17 17 17 17 17 17 17 17 17 02 16 16 16 16 16 16 16 16 16 16 16 16 16 
16 16 16 16 16 16 16 04 04 04 04 04 04 04 04 04 04 04 04 04 04 04 04 04 04 04 16 16 16 16 16 16 16 16 16 16 16 16 16 16 
16 16 16 16 16 16 16 16 16 16 16 16 16 16 16 16 16 16 16 16 16 16 16 16 16 16 16 16 16 16 16 16 16 16 16 16 16 16 16 16 
16 16 16 16 16 16 16 16 16 16 16 16 16 16 16 16 16 16 16 16 16 16 16 16 16 16 16 16 16 16 16 16 16 16 16 16 16 16 16 16 

