16 16 16 16 16 16 16 16 16 16 16 16 16 16 16 16 16 16 16 16 16 16 16 16 16 16 16 16 16 16 16 16 16 16 16 16 16 16 16 16 
16 16 16 16 16 16 16 16 16 16 16 16 16 16 16 16 16 16 16 16 16 16 16 16 16 16 16 16 16 16 16 16 16 16 16 16 16 16 16 16 
16 16 16 16 16 16 16 16 16 16 16 16 16 16 16 16 16 16 16 16 16 16 16 16 16 16 16 16 16 16 16 16 16 16 16 16 16 16 16 16 
16 16 16 16 16 16 16 16 16 16 16 16 16 16 16 16 16 16 16 16 16 16 16 16 16 16 16 16 16 16 16 16 16 16 16 16 16 16 16 16 
16 16 16 16 16 16 16 16 16 16 16 16 16 16 16 16 16 16 16 16 16 16 16 16 16 16 16 16 16 16 16 16 16 16 16 16 16 16 16 16 
16 16 16 16 16 16 16 16 16 16 16 16 16 16 16 16 16 16 16 16 16 16 16 16 16 16 16 16 16 16 16 16 16 16 16 16 16 16 16 16 
16 16 16 16 16 16 16 16 16 16 16 16 16 16 16 16 16 16 16 16 16 16 16 16 16 16 16 16 16 16 16 16 16 16 16 16 16 16 16 16 
16 16 16 16 16 16 16 16 16 16 16 16 16 16 16 16 16 16 16 16 16 16 16 16 16 16 16 16 16 16 16 16 16 16 16 16 16 16 16 16 
16 16 16 16 16 16 16 16 16 16 16 16 16 16 16 16 16 16 16 16 16 16 16 16 16 16 16 16 16 16 16 16 16 16 16 16 16 16 16 16 
16 16 16 16 16 16 16 16 16 16 16 16 16 16 16 16 16 16 16 16 16 16 16 16 16 16 16 16 16 16 16 16 16 16 16 16 16 16 16 16 
16 16 16 16 16 16 16 16 16 16 16 16 16 16 16 16 16 16 16 16 16 16 16 16 16 16 16 16 16 16 16 16 16 16 16 16 16 16 16 16 
16 16 16 16 16 16 16 16 16 16 16 16 16 16 16 16 16 16 16 16 16 16 16 16 16 16 16 16 16 16 16 16 16 16 16 16 16 16 16 16 
16 16 16 16 16 16 16 16 16 16 16 16 16 16 16 16 16 16 16 16 16 16 16 16 16 16 16 16 16 16 16 16 16 16 16 16 16 16 16 16 
16 16 16 16 16 16 16 16 16 16 16 16 16 16 16 16 16 16 16 16 16 16 05 05 05 05 05 05 05 05 05 05 05 05 05 05 05 16 16 16 
16 16 16 16 16 16 16 16 16 16 16 16 16 16 16 16 16 16 16 16 16 03 17 17 17 17 17 17 17 17 17 17 17 17 17 17 17 02 16 16 
16 16 16 16 16 16 16 16 16 16 16 16 16 16 16 16 16 16 16 16 16 03 17 17 17 17 17 17 17 17 17 17 17 17 17 17 17 02 16 16 
16 16 16 16 16 16 16 16 16 16 16 16 16 16 16 16 16 16 16 16 16 03 17 17 17 17 17 17 17 17 17 17 17 17 17 17 17 02 16 16 
16 16 16 16 16 16 16 16 16 16 16 16 16 16 16 16 16 16 16 16 16 03 17 17 17 17 17 17 17 17 17 17 17 17 17 17 17 02 16 16 
16 16 16 16 16 16 16 16 16 16 16 16 16 16 16 16 16 16 16 16 16 03 17 17 17 17 17 17 17 17 17 17 17 17 17 17 17 02 16 16 
16 16 16 16 16 16 16 16 16 16 16 16 16 16 16 16 16 16 16 16 16 03 17 17 17 17 17 17 17 17 17 17 17 17 17 17 17 02 16 16 
16 16 16 16 16 16 16 16 16 16 16 16 16 16 16 16 16 16 16 05 05 09 17 17 17 17 17 17 17 17 17 17 17 17 17 17 17 02 16 16 
16 16 16 16 16 16 16 16 16 16 16 16 16 16 16 16 16 16 03 18 18 18 18 18 18 18 18 17 17 17 17 17 17 17 17 17 17 02 16 16 
16 16 16 16 16 16 16 16 16 16 16 16 16 16 16 16 16 16 03 18 06 08 17 17 17 17 17 17 17 17 17 17 17 17 17 17 17 02 16 16 
16 16 16 16 16 16 16 16 16 16 16 16 16 16 16 16 16 16 03 18 02 03 17 17 17 17 17 17 17 17 17 17 17 17 17 17 17 02 16 16 
16 16 16 16 16 16 16 16 16 05 05 05 05 05 05 05 05 05 09 18 07 09 17 17 17 17 17 17 17 17 17 17 17 17 17 17 17 02 16 16 
16 16 16 16 16 16 16 16 03 17 17 17 17 17 17 17 17 17 17 17 17 17 17 17 17 17 17 17 17 17 17 17 17 17 17 17 17 02 16 16 
16 16 16 16 16 16 16 16 03 17 17 17 17 17 17 17 17 17 17 17 17 17 15 17 17 17 17 17 17 17 17 17 18 17 17 17 17 02 16 16 
16 16 16 16 16 16 16 16 03 17 17 17 17 17 17 17 17 17 17 17 17 17 10 17 17 17 17 17 17 17 17 17 18 17 17 17 17 02 16 16 
16 16 16 16 16 16 16 16 03 17 17 17 17 17 17 17 17 17 17 17 17 17 02 04 04 08 18 06 04 04 04 04 04 04 04 04 04 16 16 16 
16 16 16 16 16 16 16 16 03 17 17 17 17 17 17 17 17 17 17 17 17 17 02 16 16 03 18 02 16 16 16 16 16 16 16 16 16 16 16 16 
16 16 16 16 16 16 16 16 03 17 17 17 17 17 17 17 17 17 17 17 17 17 02 16 16 03 18 07 16 16 16 16 16 16 16 16 16 16 16 16 
16 16 16 16 16 16 16 16 03 17 17 17 17 17 17 17 17 17 17 17 17 17 02 16 16 03 18 18 02 16 16 16 16 16 16 16 16 16 16 16 
16 16 16 16 16 16 16 16 03 17 17 17 17 17 17 17 17 17 17 17 17 17 02 16 16 16 04 04 16 16 16 16 16 16 16 16 16 16 16 16 
16 16 16 16 16 16 16 16 03 17 17 17 17 17 17 17 17 17 17 17 17 17 02 16 16 16 16 16 16 16 16 16 16 16 16 16 16 16 16 16 
16 16 16 16 16 16 16 16 03 17 17 19 17 17 17 17 17 17 17 17 17 17 02 16 16 16 16 16 16 16 16 16 16 16 16 16 16 16 16 16 
16 16 16 16 16 16 16 16 03 17 17 17 17 17 17 17 17 17 17 17 17 17 02 16 16 16 16 16 16 16 16 16 16 16 16 16 16 16 16 16 
16 16 16 16 16 16 16 16 03 17 17 17 17 17 17 17 17 17 17 17 17 17 02 16 16 16 16 16 16 16 16 16 16 16 16 16 16 16 16 16 
16 16 16 16 16 16 16 16 16 04 04 04 04 04 04 04 04 04 04 04 04 04 16 16 16 16 16 16 16 16 16 16 16 16 16 16 16 16 16 16 
16 16 16 16 16 16 16 16 16 16 16 16 16 16 16 16 16 16 16 16 16 16 16 16 16 16 16 16 16 16 16 16 16 16 16 16 16 16 16 16 
16 16 16 16 16 16 16 16 16 16 16 16 16 16 16 16 16 16 16 16 16 16 16 16 16 16 16 16 16 16 16 16 16 16 16 16 16 16 16 16 

