16 16 16 16 16 05 16 16 16 16 16 16 16 16 16 16 16 16 16 16 16 16 16 16 16 16 16 16 16 16 16 16 16 16 16 16 16 16 16 16 
16 16 05 05 09 18 07 05 05 05 05 05 05 05 05 05 05 05 16 16 16 16 05 05 05 05 05 05 05 05 05 05 05 05 05 05 05 05 16 16 
16 03 17 17 17 17 17 17 17 17 17 17 17 17 17 17 17 17 02 05 05 09 17 17 17 17 17 17 17 17 17 17 17 17 17 17 17 17 02 16 
16 03 17 17 17 17 17 17 17 17 17 17 17 17 17 17 17 17 10 18 18 18 17 17 17 17 17 17 17 17 17 17 17 17 17 17 17 17 02 16 
16 03 17 17 17 17 17 17 17 17 17 17 17 17 17 17 17 17 15 18 06 08 17 17 17 17 17 17 17 17 17 17 17 17 17 17 17 17 02 16 
16 03 17 17 17 17 17 17 17 17 17 17 17 17 17 17 17 17 18 18 02 03 17 17 17 17 17 17 17 17 17 17 17 17 17 17 17 17 02 16 
16 03 17 17 17 17 17 17 17 17 17 17 17 17 17 17 17 17 14 18 02 03 17 17 17 17 17 17 17 17 17 17 17 17 17 17 17 17 02 16 
16 03 17 17 17 17 17 17 17 17 17 17 17 17 17 17 17 17 10 18 02 03 17 17 17 17 17 17 17 17 17 17 17 17 17 17 17 17 02 16 
16 16 04 11 13 18 12 11 11 11 11 11 11 11 11 11 11 11 09 18 07 05 11 11 13 18 12 11 11 04 04 04 04 04 04 04 04 04 16 16 
16 16 03 18 18 18 18 18 18 18 18 18 18 18 18 18 18 18 18 18 18 18 18 18 18 18 18 18 18 02 16 16 16 16 16 16 16 16 16 16 
16 16 03 18 06 04 04 04 04 04 04 08 18 06 04 04 04 04 08 18 06 04 04 04 04 04 04 04 04 16 16 16 16 16 16 16 16 16 16 16 
16 16 09 18 07 05 05 05 05 05 05 03 18 02 16 05 05 05 09 18 07 05 05 05 05 05 05 05 05 05 05 05 05 05 05 05 05 05 16 16 
16 03 17 17 17 17 17 17 17 17 17 10 18 07 09 17 17 17 17 17 17 17 17 17 17 17 17 17 17 17 17 17 17 17 17 17 17 17 02 16 
16 03 17 17 17 17 17 17 17 17 17 10 18 18 18 17 17 17 17 17 17 17 17 17 17 17 17 17 17 17 17 17 17 17 17 17 17 17 02 16 
16 03 17 17 17 17 17 17 17 17 17 15 18 06 08 17 17 17 17 17 17 17 17 17 17 17 17 17 17 17 17 17 17 17 17 17 17 17 02 16 
16 03 17 17 17 17 17 17 17 17 17 18 18 02 03 17 17 17 17 17 17 17 17 17 17 17 17 17 17 17 17 17 17 17 17 17 17 17 02 16 
16 03 19 17 17 17 17 17 17 17 17 14 18 02 03 17 17 17 17 17 17 17 17 17 17 17 17 17 17 17 17 17 17 17 17 17 17 17 02 16 
16 03 17 17 17 17 17 17 17 17 17 10 18 02 03 17 17 17 17 17 17 17 17 17 17 17 17 17 17 17 17 17 17 17 17 17 17 17 02 16 
16 16 08 18 12 11 11 11 11 11 11 09 18 02 03 17 17 17 17 17 17 17 17 17 17 17 17 17 17 17 17 17 17 17 17 17 17 17 02 16 
16 16 03 18 18 18 18 18 18 18 18 18 18 02 03 17 17 17 17 17 17 17 17 17 17 17 17 17 17 17 17 17 17 17 17 17 17 17 02 16 
16 16 16 04 08 18 06 04 04 04 04 08 18 02 03 17 17 17 17 17 17 17 17 17 17 17 17 17 17 17 17 17 17 17 17 17 17 17 02 16 
16 16 05 05 09 18 07 05 05 05 05 03 18 02 03 17 17 17 17 17 17 17 17 17 17 17 17 17 17 17 17 17 17 17 17 17 17 17 02 16 
16 03 17 17 17 17 17 17 17 17 17 10 18 02 03 17 17 17 17 17 17 17 17 17 17 17 17 17 17 17 17 17 17 17 17 17 17 17 02 16 
16 03 17 17 17 17 17 17 17 17 17 10 18 02 03 17 17 17 17 17 17 17 17 17 17 17 17 17 17 17 17 17 17 17 17 17 17 17 02 16 
16 03 17 17 17 17 17 17 17 17 17 10 18 02 03 17 17 17 17 17 17 17 17 17 17 17 17 17 17 17 17 17 17 17 17 17 17 17 02 16 
16 03 17 17 17 17 17 17 17 17 17 10 18 02 03 17 17 17 17 17 17 17 17 17 17 17 17 17 17 17 17 17 17 17 17 17 17 17 02 16 
16 03 17 17 17 17 17 17 17 17 17 10 18 02 03 17 17 17 17 17 17 17 17 17 17 17 17 17 17 17 17 17 17 17 17 17 17 17 02 16 
16 03 17 17 17 17 17 17 17 17 17 10 18 02 03 17 17 17 17 17 17 17 17 17 17 17 17 17 17 17 17 17 17 17 17 17 17 17 02 16 
16 03 17 17 17 17 17 17 17 17 17 10 18 02 03 17 17 17 17 17 17 17 17 17 17 17 17 17 17 17 17 17 17 17 17 17 17 17 02 16 
16 03 17 17 17 17 17 17 17 17 17 10 18 02 03 17 17 17 17 17 17 17 17 17 17 17 17 17 17 17 17 17 17 17 17 17 17 17 02 16 
16 03 17 17 17 17 17 17 17 17 17 10 18 02 03 17 17 17 17 17 17 17 17 17 17 17 17 17 17 17 17 17 17 17 17 17 17 17 02 16 
16 03 17 17 17 17 17 17 17 17 17 15 18 02 03 17 17 17 17 17 17 17 17 17 17 17 17 17 17 17 17 17 17 17 17 17 17 17 02 16 
16 03 17 17 17 17 17 17 17 17 17 18 18 02 03 17 17 17 17 17 17 17 17 17 17 17 17 17 17 17 17 17 17 17 17 17 17 17 02 16 
16 03 17 17 17 17 17 17 17 17 17 14 18 02 03 17 17 17 17 17 17 17 17 17 17 17 17 17 17 17 17 17 17 17 17 17 17 17 02 16 
16 03 17 17 17 17 17 17 17 17 17 10 18 02 03 17 17 17 17 17 17 17 17 17 17 17 17 17 17 17 17 17 17 17 17 17 17 17 02 16 
16 03 17 17 17 17 17 17 17 17 17 10 18 02 03 17 17 17 17 17 17 17 17 17 17 17 17 17 17 17 17 17 17 17 17 17 17 17 02 16 
16 03 17 17 17 17 17 17 17 17 17 10 18 02 03 17 17 17 17 17 17 17 17 17 17 17 17 17 17 17 17 17 17 17 17 17 17 17 02 16 
16 03 17 17 17 17 17 17 17 17 17 10 18 02 03 17 17 17 17 17 17 17 17 17 17 17 17 17 17 17 17 17 17 17 17 17 17 17 02 16 
16 16 04 04 08 18 06 04 04 04 04 03 18 02 16 04 04 04 04 04 04 04 04 04 04 04 04 04 04 04 04 04 04 04 04 04 04 04 16 16 
16 16 16 16 16 04 16 16 16 16 16 16 04 16 16 16 16 16 16 16 16 16 16 16 16 16 16 16 16 16 16 16 16 16 16 16 16 16 16 16 

