16 16 16 16 16 16 16 16 16 16 16 16 16 16 16 16 16 16 16 16 16 16 16 16 16 16 16 16 16 16 16 16 16 16 16 16 16 16 16 16 
16 16 16 16 16 16 16 16 16 16 16 16 16 16 16 16 16 16 16 16 16 16 16 16 16 16 16 16 16 16 16 16 16 16 16 16 16 16 16 16 
16 16 16 16 16 16 16 16 16 16 16 16 16 16 16 16 16 16 16 16 16 16 16 16 16 16 16 16 16 16 16 16 16 16 16 16 16 16 16 16 
16 16 16 16 16 16 16 16 16 16 16 16 16 16 16 16 16 16 16 16 16 16 16 16 16 16 16 16 16 16 16 16 16 16 16 16 16 16 16 16 
16 16 16 16 16 16 16 16 16 16 16 16 16 16 16 16 16 16 16 16 16 16 16 16 16 16 16 16 16 16 16 16 16 16 16 16 16 16 16 16 
16 16 16 16 16 16 16 16 16 16 16 16 16 16 16 16 16 16 16 16 16 16 16 16 16 16 16 16 16 16 16 16 16 16 16 16 16 16 16 16 
16 16 16 16 16 16 16 16 16 16 16 16 16 16 16 16 16 16 16 16 16 16 16 16 16 16 16 16 16 16 16 16 16 16 16 16 16 16 16 16 
16 16 16 16 16 16 16 16 16 16 16 16 16 16 16 16 16 16 16 16 16 16 16 16 16 16 16 16 16 16 16 16 16 16 16 16 16 16 16 16 
16 16 16 16 16 16 16 16 16 16 16 16 16 16 16 16 16 16 16 16 16 16 16 16 16 16 16 16 16 16 16 16 16 16 16 16 16 16 16 16 
16 16 16 16 16 16 16 16 16 16 16 16 16 16 16 16 16 16 16 16 16 16 16 16 16 16 16 16 16 16 16 16 16 16 16 16 16 16 16 16 
16 16 16 16 16 16 16 16 16 16 16 16 16 16 16 16 16 16 16 16 16 16 16 16 16 16 16 16 16 16 16 16 16 16 16 16 16 16 16 16 
16 16 16 16 16 16 16 16 16 16 16 16 16 16 16 16 16 16 16 16 16 16 16 16 16 16 16 16 16 16 16 16 16 16 16 16 16 16 16 16 
16 16 16 16 16 16 16 16 16 16 16 16 16 16 16 16 16 16 16 16 16 16 16 16 16 16 16 16 16 16 16 16 16 16 16 16 16 16 16 16 
16 16 16 16 16 16 16 16 16 16 16 16 16 16 16 16 16 16 16 16 16 16 16 16 16 16 16 16 16 16 16 16 16 16 16 16 16 16 16 16 
16 16 16 16 16 16 16 16 16 16 16 16 16 16 16 16 16 16 16 16 16 16 16 16 16 16 16 16 16 16 16 16 16 16 16 16 16 16 16 16 
16 16 16 16 16 16 16 16 16 16 16 16 16 16 16 16 16 16 16 16 16 16 16 16 16 16 16 16 16 16 16 16 16 16 16 16 16 16 16 16 
16 16 16 16 16 16 16 16 16 16 16 16 16 16 16 16 16 16 16 16 16 05 05 05 05 05 05 05 05 05 05 05 05 05 05 05 16 16 16 16 
16 16 16 16 16 16 16 16 16 16 16 16 16 16 16 16 16 16 16 16 03 17 17 17 17 17 17 17 17 17 17 17 17 17 17 17 02 16 16 16 
16 16 16 16 16 16 16 16 16 16 16 16 16 16 16 16 16 16 16 16 03 17 17 17 17 17 17 17 17 17 17 17 17 17 17 17 02 16 16 16 
16 16 16 16 16 16 16 16 16 16 16 16 16 16 16 16 16 16 16 16 03 17 17 17 17 17 17 17 17 17 17 17 17 17 17 17 02 16 16 16 
16 16 16 16 16 16 16 16 16 16 16 16 16 16 16 16 16 16 16 16 03 17 17 17 17 17 17 17 17 17 17 17 17 17 17 17 02 16 16 16 
16 16 16 16 16 16 16 16 16 16 16 16 16 16 16 16 16 16 16 16 03 17 17 17 17 17 17 17 17 17 17 17 17 17 17 17 02 16 16 16 
16 16 16 16 16 16 16 16 05 05 05 05 05 05 05 05 05 05 05 05 09 17 17 17 17 17 17 17 17 17 17 17 17 17 17 17 02 16 16 16 
16 16 16 16 16 16 16 03 17 17 17 17 17 17 17 17 17 17 17 17 17 17 17 17 17 17 17 17 17 17 17 17 17 17 17 17 02 16 16 16 
16 16 16 16 16 16 16 03 17 17 17 17 17 17 17 17 17 17 17 17 17 17 17 17 17 17 17 17 17 17 17 17 17 17 17 17 02 16 16 16 
16 16 16 16 16 16 16 03 17 17 17 17 17 17 17 17 17 17 17 17 17 17 17 18 18 17 17 17 17 06 04 04 04 04 04 04 16 16 16 16 
16 16 16 16 16 16 16 03 17 17 19 17 17 17 17 17 17 17 17 17 17 17 17 17 17 17 17 17 17 02 16 16 16 16 16 16 16 16 16 16 
16 16 16 16 16 16 16 03 17 17 17 17 17 17 17 17 17 17 17 17 17 17 17 17 17 17 17 17 17 02 16 16 16 16 16 16 16 16 16 16 
16 16 16 16 16 16 16 03 17 17 17 17 17 17 17 17 17 17 17 17 17 17 17 17 17 17 17 17 17 02 16 16 16 16 16 16 16 16 16 16 
16 16 16 16 16 16 16 03 17 17 17 17 17 17 17 17 17 17 17 17 17 17 17 17 17 17 17 17 17 02 16 16 16 16 16 16 16 16 16 16 
16 16 16 16 16 16 16 03 17 17 17 17 17 17 17 17 17 17 17 17 17 17 17 17 17 06 04 04 04 16 16 16 16 16 16 16 16 16 16 16 
16 16 16 16 16 16 16 03 17 17 17 17 17 17 17 17 17 17 17 17 17 17 17 17 17 02 16 16 16 16 16 16 16 16 16 16 16 16 16 16 
16 16 16 16 16 16 16 03 17 17 17 17 17 17 17 17 17 17 17 17 17 17 17 17 17 02 16 16 16 16 16 16 16 16 16 16 16 16 16 16 
16 16 16 16 16 16 16 03 17 17 17 17 17 17 17 17 17 17 17 17 17 17 17 17 17 02 16 16 16 16 16 16 16 16 16 16 16 16 16 16 
16 16 16 16 16 16 16 03 17 17 17 17 17 17 17 17 17 17 17 17 17 17 17 17 17 02 16 16 16 16 16 16 16 16 16 16 16 16 16 16 
16 16 16 16 16 16 16 03 17 17 17 17 17 17 17 17 17 17 17 17 17 17 17 17 17 02 16 16 16 16 16 16 16 16 16 16 16 16 16 16 
16 16 16 16 16 16 16 03 17 17 17 17 17 17 17 17 17 17 17 17 17 17 17 17 17 02 16 16 16 16 16 16 16 16 16 16 16 16 16 16 
16 16 16 16 16 16 16 16 04 04 04 04 04 04 04 04 04 04 04 04 04 04 04 04 04 16 16 16 16 16 16 16 16 16 16 16 16 16 16 16 
16 16 16 16 16 16 16 16 16 16 16 16 16 16 16 16 16 16 16 16 16 16 16 16 16 16 16 16 16 16 16 16 16 16 16 16 16 16 16 16 
16 16 16 16 16 16 16 16 16 16 16 16 16 16 16 16 16 16 16 16 16 16 16 16 16 16 16 16 16 16 16 16 16 16 16 16 16 16 16 16 

