16 16 16 16 16 16 16 16 16 16 16 16 16 16 16 16 16 16 16 16 16 16 16 16 16 16 16 16 16 16 16 16 16 16 16 16 16 16 16 16 
16 16 16 16 16 16 16 16 16 16 16 16 16 16 16 16 16 16 16 16 16 16 16 16 16 16 16 16 16 16 16 16 16 16 16 16 16 16 16 16 
16 16 16 16 16 16 16 16 16 16 16 16 16 16 16 16 16 16 16 16 16 16 16 16 16 16 16 16 16 16 16 16 16 16 16 16 16 16 16 16 
16 16 16 16 16 16 16 16 16 16 16 16 16 16 16 16 16 16 16 16 16 16 16 16 16 16 16 16 16 16 16 16 16 16 16 16 16 16 16 16 
16 16 16 16 16 16 16 16 16 16 16 16 16 16 16 16 16 16 16 16 16 16 16 16 16 16 16 16 16 16 16 16 16 16 16 16 16 16 16 16 
16 16 16 16 16 16 16 16 16 16 16 16 16 16 16 16 16 16 16 16 16 16 16 16 16 16 16 16 16 16 16 16 16 16 16 16 16 16 16 16 
16 16 16 16 16 16 16 16 16 16 16 16 16 16 16 16 16 16 16 16 16 16 16 16 16 16 16 16 16 16 16 16 16 16 16 16 16 16 16 16 
16 16 16 16 16 16 16 16 16 16 16 16 16 16 16 16 16 16 16 16 16 16 16 16 16 16 16 16 16 16 16 16 16 16 16 16 16 16 16 16 
16 16 16 16 16 16 16 16 16 16 16 16 16 16 16 16 16 16 16 16 16 16 16 16 16 16 16 16 16 16 16 16 16 16 16 16 16 16 16 16 
16 16 16 16 16 16 16 16 16 16 16 16 16 16 16 16 16 16 16 16 16 16 16 16 16 16 16 16 16 16 16 16 16 16 16 16 16 16 16 16 
16 16 16 16 16 16 16 16 16 05 05 05 05 05 05 05 05 05 05 05 05 05 05 16 16 16 16 16 16 16 16 16 16 16 16 16 16 16 16 16 
16 16 16 16 16 16 16 16 03 17 17 17 17 17 17 17 17 17 17 17 17 17 17 02 16 16 16 16 16 16 16 16 16 16 16 16 16 16 16 16 
16 16 16 16 16 16 16 16 03 17 17 17 17 17 17 17 17 17 17 17 17 17 17 02 16 16 16 16 16 16 16 16 16 16 16 16 16 16 16 16 
16 16 16 16 16 16 16 16 03 17 17 17 17 17 17 17 17 17 17 17 17 17 17 02 16 16 16 16 16 16 16 05 05 05 05 05 05 16 16 16 
16 16 16 16 16 16 16 16 03 17 17 17 17 17 17 17 17 17 17 17 17 17 17 02 16 16 16 16 16 16 03 17 17 17 17 17 17 02 16 16 
16 16 16 16 16 16 16 16 03 17 17 17 17 17 17 17 17 17 17 17 17 17 17 07 05 05 05 05 16 16 03 17 17 17 17 17 17 02 16 16 
16 16 16 16 16 16 16 16 03 17 17 17 17 17 17 17 17 17 17 17 17 17 17 18 18 18 18 18 02 16 03 17 17 17 17 17 17 02 16 16 
16 16 16 16 16 16 16 16 03 17 17 17 17 17 17 17 17 17 17 17 17 17 17 06 04 04 13 18 07 05 09 17 17 17 17 17 17 02 16 16 
16 16 16 16 16 16 16 16 03 17 17 17 17 17 17 17 17 17 17 17 17 17 17 02 16 03 17 18 18 18 18 18 18 18 18 18 17 02 16 16 
16 16 16 16 16 16 16 16 16 04 04 04 04 04 04 04 04 04 11 11 11 11 11 05 05 09 17 17 17 17 17 17 17 17 17 17 17 02 16 16 
16 16 16 16 16 16 16 16 16 16 16 16 16 16 16 16 16 03 18 18 18 18 18 18 18 18 18 18 18 18 17 17 17 17 17 17 17 02 16 16 
16 16 16 16 16 16 16 16 16 16 16 16 16 16 16 16 16 03 18 06 04 04 04 04 04 08 17 17 17 17 17 17 17 17 17 17 17 02 16 16 
16 16 16 16 16 16 16 16 16 16 16 16 16 16 16 16 16 03 18 02 16 16 16 16 16 03 17 17 17 17 17 17 17 17 17 17 17 02 16 16 
16 16 16 16 16 16 16 16 16 16 16 16 16 16 16 16 16 03 18 02 16 16 16 16 16 03 17 17 17 17 17 17 17 17 17 17 17 02 16 16 
16 16 16 16 16 05 05 05 05 05 05 05 05 05 16 16 16 03 18 02 16 16 16 16 16 03 17 17 17 17 17 17 17 17 17 17 17 02 16 16 
16 16 16 16 03 17 17 17 17 17 17 17 17 17 02 16 16 03 18 02 16 16 16 16 16 03 17 17 17 17 17 17 17 17 17 17 17 02 16 16 
16 16 16 16 03 17 17 17 17 17 17 17 17 17 02 16 16 03 18 02 16 16 16 16 16 03 17 17 17 17 17 17 17 17 17 17 17 02 16 16 
16 16 16 16 03 17 17 17 17 17 17 17 17 19 07 05 05 09 18 02 16 16 16 16 16 03 17 17 17 17 17 17 17 17 17 17 17 02 16 16 
16 16 16 16 03 17 17 17 17 17 17 17 17 17 18 18 18 18 18 02 16 16 16 16 16 16 04 04 04 04 04 04 04 04 04 04 04 16 16 16 
16 16 16 16 03 17 17 17 17 17 17 17 17 17 06 04 04 04 04 16 16 16 16 16 16 16 16 16 16 16 16 16 16 16 16 16 16 16 16 16 
16 16 16 16 03 17 17 17 17 17 17 17 17 17 02 16 16 16 16 16 16 16 16 16 16 16 16 16 16 16 16 16 16 16 16 16 16 16 16 16 
16 16 16 16 03 17 17 17 17 17 17 17 17 17 02 16 16 16 16 16 16 16 16 16 16 16 16 16 16 16 16 16 16 16 16 16 16 16 16 16 
16 16 16 16 03 17 17 17 17 17 17 17 17 17 02 16 16 16 16 16 16 16 16 16 16 16 16 16 16 16 16 16 16 16 16 16 16 16 16 16 
16 16 16 16 03 17 17 17 17 17 17 17 17 17 02 16 16 16 16 16 16 16 16 16 16 16 16 16 16 16 16 16 16 16 16 16 16 16 16 16 
16 16 16 16 03 17 17 17 17 17 17 17 17 17 02 16 16 16 16 16 16 16 16 16 16 16 16 16 16 16 16 16 16 16 16 16 16 16 16 16 
16 16 16 16 03 17 17 17 17 17 17 17 17 17 02 16 16 16 16 16 16 16 16 16 16 16 16 16 16 16 16 16 16 16 16 16 16 16 16 16 
16 16 16 16 03 17 17 17 17 17 17 17 17 17 02 16 16 16 16 16 16 16 16 16 16 16 16 16 16 16 16 16 16 16 16 16 16 16 16 16 
16 16 16 16 16 04 04 04 04 04 04 04 04 04 16 16 16 16 16 16 16 16 16 16 16 16 16 16 16 16 16 16 16 16 16 16 16 16 16 16 
16 16 16 16 16 16 16 16 16 16 16 16 16 16 16 16 16 16 16 16 16 16 16 16 16 16 16 16 16 16 16 16 16 16 16 16 16 16 16 16 
16 16 16 16 16 16 16 16 16 16 16 16 16 16 16 16 16 16 16 16 16 16 16 16 16 16 16 16 16 16 16 16 16 16 16 16 16 16 16 16 

